101 101 101 101 101 101 101 101 101 101 101 101 0 0 0 0 0 0 0 0 0 0 104 0 104 0 0 104 0 0 104 0 104 104 104 104
101 101 101 101 101 101 101 101 101 101 101 101 0 0 104 104 0 0 0 0 0 0 0 0 0 0 104 0 0 104 0 0 0 0 0 104
101 101 101 101 101 101 101 101 101 101 101 101 0 104 0 0 0 0 0 104 0 0 0 0 104 0 104 0 0 0 0 0 0 0 104 104
0 0 0 0 0 0 101 101 101 101 101 101 0 0 0 0 0 104 0 0 0 0 104 104 0 0 0 0 1 1 9 0 0 0 0 3
0 0 0 0 0 0 101 101 101 101 101 101 101 0 0 0 0 0 0 0 0 104 0 0 0 0 1 1 1 0 0 104 104 104 3 102
0 0 0 0 0 0 0 101 101 101 101 101 101 101 101 0 0 0 0 0 0 0 1 1 1 1 1 0 104 104 104 0 0 3 102 102
0 0 0 0 0 0 0 0 101 101 101 101 101 101 101 0 104 0 0 0 0 0 1 0 0 0 104 104 0 0 0 0 104 3 102 102
0 0 0 2 2 2 0 0 0 0 101 101 101 101 0 0 0 0 104 0 0 0 1 104 0 104 0 0 0 0 0 0 0 3 3 102
0 0 2 2 103 103 103 103 2 2 0 0 0 102 102 102 0 0 0 0 104 0 1 104 104 104 0 0 104 0 0 3 3 3 102 102
2 2 2 103 2 2 2 2 103 2 2 2 0 0 0 102 102 102 0 0 0 0 1 1 1 1 0 0 0 0 3 3 3 102 102 102
2 2 103 2 2 2 2 2 2 103 2 2 2 0 0 0 0 102 102 0 0 0 0 0 0 0 1 0 0 0 3 3 102 102 102 102
2 2 103 2 2 2 2 2 2 103 2 2 2 0 0 0 0 102 102 102 102 0 0 0 0 0 1 1 0 104 0 3 3 102 102 102
2 2 103 2 2 2 2 2 2 103 2 2 0 0 110 110 110 110 110 110 102 102 0 0 0 0 1 1 0 0 0 0 3 3 102 102
2 2 2 2 2 2 2 2 2 2 2 2 110 110 111 111 111 2 2 111 110 102 102 102 0 0 4 4 0 0 0 0 0 3 3 102
0 0 2 2 2 2 2 2 2 2 0 0 110 111 2 2 2 2 2 2 111 110 102 102 102 102 4 4 0 0 0 0 3 3 3 102
0 0 0 0 0 2 2 0 0 0 0 0 110 111 2 2 2 2 2 2 2 2 110 102 102 102 4 4 102 0 0 3 3 3 102 102
0 0 0 0 0 1 1 1 1 1 110 110 2 2 2 2 2 2 2 2 2 2 110 110 110 0 1 1 102 102 3 3 102 102 102 102
3 0 0 0 0 1 1 1 1 1 1 2 2 2 2 2 2 2 2 2 2 2 2 2 2 1 1 1 102 102 102 3 102 102 102 102
3 3 0 0 0 0 0 0 0 3 3 110 2 2 2 2 2 2 2 2 2 2 2 2 2 1 1 1 3 3 102 102 102 102 102 102
3 3 3 0 3 3 3 3 0 3 3 3 110 2 2 2 2 2 2 2 2 2 110 110 110 3 3 3 3 3 3 102 102 102 102 102
102 102 102 102 102 102 102 102 102 102 102 102 102 110 110 110 110 110 110 110 110 110 3 3 3 3 3 3 3 3 102 102 102 102 102 102